111111111111111111111111111111111
1E000000000000C00000C000000000001
101001100100000101001000000010101
101001010101010001001000000010101
1P0000001C010000000000011000100C1
111111111111111111111111111111111
