1111111111
1000000E01
10001C1001
1P00111001
1111111111
